3
2
4
2
XXXXXXX
XXXXXXX
XXXXXXX
XXXRXXX
X______
XpXXKXX