3
2
4
2
XXXXXXX
XXXXXXX
XXXXXXX
XXXxXXX
X______
XpXX_XX