3
1
4
2
XXXXXXX
XXXXXXX
XXXXXXX
XXXFXXX
X______
XpXXKXX